11111111111111111111101111111111111111111
10000000000000100010000010000000000000001
10111011111110101011101110111111111111101
101x101000100010100010100000000x100000101
10101010101011101011101110101111101010101
1010101x100010001000000000100000001010101
10101011111110111011111111111111111010101 
10001000000000100000000000100000001010101
10111111111111101110101110101111101010101
10000000000000101x10101x10100010001010101
10111111111110101010101010111010101010101
101000001000001000101010101x10101x1010101
10101110101111111010111010101010111010101
10101x00101000000010000010001010100010101
10101111101011111011111110101010101110101
10100000000010000000000000101010101x10101
10101111111110111011111110101010101010101
10101000100000100000000010101010101010101
10101010101111101011111010101010101010101
101000101010000010000x1010001010101000101
10111111101010111011111011111010101011101
10100000001010100000000010000010101010001
10101111111010111111111110111110101110111
10001x00000010000000000000000000101000101
10111111111111111010111110111011101011101
101000000000000000100000101x1010001010001
10101111111111111010111011101010101010101
100010000000001000101x100000101010101x101
10001011111110111010101110111010111011101
10001000000x10000010000010000010000000001
11111111111111111111111111111111111111111                          