11111111111111111111111111111011111
10100x1000001000000000000000001x001
10101110111011111010111011111111101
100000001010000000100x1000001000001
11111110101011111111111011101110101
1010000010001x000010001010000010101
10101111101011101010101110111110101
101000001010100010001000100000001x1
10111110101010111111111010101111111
10000x101x10101000000x1010100000001
10111110111110101011111010111011101
1010000010001000100010001x10001x101
10101111101011111110101111101110101
100010000010001010001000001000101x1
10111011111110101011111110111010111
10100000100010001000100000100010001
10111110101111101110101011101110111
100000001000000010001x1000001x10101
10111111101010111011111111111010101
1010001x101010000010000010000010001
10100010101011111110101111101110101
100000100010000000001000000000001x1
11111111111111111111111111111111111