11111111111111111011111111111111111111111
100000000010000000001x0000001x00000010001
10111011101011111010111110101111111010101
101x101x101010000010100000100000000010101
10101010101010111110101111111111111110101
10001010001010000x10100000000000000000101
10111010111011111110101111111111111111101
10100010100000000010101000001000000x10001
11101110101111111010101110101011111110101
10001010101000001010100000101010000000101
10111010101011101010111111101010111111101
101000101010100010101000100000101x1000101
10101010101010111010101010111110101010101
101010101010101x10101x1000100000100010101
10101010101010101010111111101111111110101
10101x10101010101010000000001000000000101
10101110101010101011111111111010111110101
10101000101010001000101000000010100x10101
10101011101010111010101011111110101110101
1010101x101010100010101000100000100000101
10101010101011101110101110101111111111101
10101010001000101x10100x10100000000000001
10101010111110101010101110111111111111111
10101010000000101000101000100000000010001
10101011111111101110101011101111111010001
101010100000001000101010100010001x1010001
10101010111110111010101010111010101010101
10100000100000000010001010100010001010101
10111111101111111111111010101111111011101
10000000000000000000000000100000000000001
11111111111111111111111111111111111111111