1111111111111111111111111111111
00001x0000100010000010000010001
1110111010101011101010111010101
10100010101010000010101000101x1
1011101010101111111010101110111
1000100010001000001010101x10001
1010111111101011101010101010101
1010100000100010001000101000101
1010101110101110111111101111101
1010101x10100010000x10001000001
1010101010111010101110111010111
10100010100010101010001000101x1
1011111011101010101011101110101
1010000010100010101000001000101
1010111010111110101111111010101
10101x10001x0000101x00000010101
1010101110111011101111101110101
1010100010001010001000001x10101
1010111011101010111011111010101
1010001000000010001010000010101
1011101111101111101010101010101
100000100010100000001x101010101
1010111010101011111111101110101
10100000101x1000100000100000101
1011101110111110101110111011101
100010001000001010001000100x101
1010111011111010111011101111101
1010001x100010000x1010001000001
1011101110101111111010111000001
1000100000100000000010000000001
1111111111111111111111111111111